1 1 1 1 1 1 1 1 1 1 1 4 4 6 4 4 6 4 6 4 4 4 6 4
1 0 0 0 0 0 0 0 0 0 0 4 0 0 0 0 0 0 0 0 0 0 0 4
1 0 3 3 0 0 0 0 0 0 0 4 0 0 0 0 0 0 0 0 0 0 0 6
1 0 0 3 0 0 0 0 0 0 0 0 0 0 0 0 0 0 0 0 0 0 0 6
1 0 3 3 0 0 0 0 0 0 0 4 0 0 0 0 0 0 0 0 0 0 0 4
1 0 0 0 0 0 0 0 0 0 0 4 0 0 0 0 0 6 6 6 0 6 4 6
1 0 0 0 0 0 0 0 0 0 0 4 4 4 4 4 4 6 0 0 0 0 0 6
6 6 6 6 0 6 6 6 6 0 0 0 0 0 0 0 0 4 0 4 0 6 0 6
6 6 0 0 0 0 0 0 6 0 0 0 0 0 0 0 0 6 0 0 0 0 0 6
6 0 0 0 0 0 0 0 0 0 0 0 0 0 0 0 0 6 0 0 0 0 0 4
6 0 0 0 0 0 0 0 0 0 0 0 0 0 0 0 0 6 0 6 0 6 0 6
6 6 0 0 0 0 0 0 6 0 0 0 0 0 0 0 0 6 4 6 0 6 6 6
6 6 6 6 0 6 6 6 6 0 0 4 0 6 0 4 0 3 3 3 0 3 3 3
2 2 2 2 0 2 2 2 2 4 6 4 0 0 6 0 6 3 0 0 0 0 0 3
2 2 0 0 0 0 0 2 2 4 0 0 0 0 0 0 4 3 0 0 0 0 0 3
2 0 0 0 0 0 0 0 2 4 0 0 0 0 0 0 4 3 0 0 0 0 0 3
1 0 0 0 0 0 0 0 1 4 4 4 4 4 6 0 6 3 3 0 0 0 3 3
2 0 0 0 0 0 0 0 2 2 2 1 2 2 2 6 6 0 0 5 0 5 0 5
2 2 0 0 0 0 0 2 2 2 0 0 0 2 2 0 5 0 5 0 0 0 5 5
2 0 0 0 0 0 0 0 2 0 0 0 0 0 2 5 0 5 0 5 0 5 0 5
1 0 0 0 0 0 0 0 0 0 0 0 0 0 0 0 0 0 0 0 0 0 0 5
2 0 0 0 0 0 0 0 2 0 0 0 0 0 2 5 0 5 0 5 0 5 0 5
2 2 0 0 0 0 0 2 2 2 0 0 0 2 2 0 5 0 5 0 0 0 5 5
2 2 2 2 1 2 2 2 2 2 2 1 2 2 2 5 5 5 5 5 5 5 5 5
